1111111111111111111111111111
1000060000000600000106000011
1000000000000000000101111011
1000000000000000000101001011
1000000000000000000101001011
1000000000000000000001111011
1000000000000000000000000011
1000000000000000000111111011
1000000000000000000100600011
1000000000000000000101111011
1000000000000000000100600011
1000000000000000000101111111
1000000000000000000000000011
1000000000000000000000000011
1000000000000000000000000011
1000000000000000000000000011
1000000000000000000000000011
1000000000000000000000000011
1600000000000000000000000011
1000000000000000000000000011
1000000000000000000000000011
1000000000000000000000000011
1000000000000000000000000011
1000000000000000000000000011
1600000000000000000000000011
1000000000000000000000000011
1000000000053332666666000011
1111111111111111111111111111