1111111111111111111111111111
1111111111111111111111111111
1100606011000660001100006011
1101111011611111101101111011
1100000011010000101101001011
1111111010010000100101001011
1100006060011001100061111011
1100000060000600000000060011
1101101111110000601111111611
1101101111110606601106660011
1101100000000600001101111011
1101101011600611661166000011
1101101011000011001101111111
1101101011000011000661111111
1101161011600011000000606611
1161101611000000061111111011
1161101011000011001100660011
1101101011000011001101111611
1101161011660611061101111111
1160001611006611060061111111
1101101011000011000000000011
1101101011111110001166600011
1161166000000000661161111611
1161111111111111001106601011
1161111111111111001161660011
1100066000053332000661111111
1111111111111111111111111111
1111111111111111111111111111