1111111111111111111111111111
1100006006000000000006000011
1101101110011100110111111611
1101100006000000110000000011
1161101111111110110111111111
1101100000000600110110006011
1101101110011110110116111011
1160000006000000110000000011
1100000000000000000100006011
1101106000060000006101111011
1101100000000000110100600011
1161101101101101101101101111
1101161101101161101100006011
1101101101161101101101111011
1101101101101101101100600011
1101101161101100001101111011
1101101101101100061600011011
1100000600000000011011011011
1160001101111111011011006011
1101101101100011011011011011
1101101101100011011011011011
1101101101100011011011011011
1101101161100011011011011611
1161101101111111011011011011
1101100006000600000006011011
1101111001111110011101111011
1100600006053332000006000011
1111111111111111111111111111