1111111111111111111111111111
1166600000000000666600006611
1101101110611166116111111611
1101100000000000110000000011
1101161111111116116111111111
1101100000000000110110000011
1101161116611116116116111011
1100000000066600110066600011
1100066600000006660100000611
1161166660000000666161111611
1101100000000000110100000011
1101101101101101101101101111
1101101101101101101100000011
1161161161161161161161111611
1161161161161161161166660011
1101101101101100001101111011
1101161161161166661000011011
1100000000000000011011011011
1100001101111111611611666011
1101161161166611611611611611
1161161161100011011011011011
1101101101100011011011011011
1101101101100011011011011011
1161161161111111611611611611
1101100000000000000000011011
1101111061111116611161111611
1166600000053332006660066611
1111111111111111111111111111