1111111111111111111111111111
1111111111111111111111111111
1160000611060000001100600611
1101111011011111101101111011
1100060011016666101101001011
1111111016010000106101001011
1100000000011001100001111011
1100000006600000000066000011
1101101111110000001111111011
1101101111110066001106000011
1101160000000000001101111011
1101101011000011001106000011
1101101011600611001101111111
1161101611000011000001111111
1101101011000011000006000011
1101101011000060001111111011
1101101011000011001100000011
1101101011000011001101111011
1101101011000011001101111111
1100601011000011000001111111
1101161011600611000000000611
1101101011111116001100000611
1101100000000000001101111011
1161111111111111061106001011
1101111111111111001101000611
1100060000053332000061111111
1111111111111111111111111111
1111111111111111111111111111